sap	SP
sat	ST
sad	ST
rat	RT
rap	RP
ram	RM
rag	RK
nap	NP
Nat	NT
mat	MT
map	MP
mad	MT
lap	LP
lag	LK
lad	LT
fat	FT
fan	FN
fad	FT
fin	FN
fit	FT
lid	LT
lip	LP
lit	LT
mid	MT
mitt	MT
nit	NT
nip	NP
rid	RT
rig	RK
rim	RM
rip	RP
Sid	ST
sin	SN
sip	SP
log	LK
mom	MM
mop	MP
nod	NT
rod	RT
Ron	RN
rot	RT
sod	ST
fun	FN
mud	MT
mum	MM
nut	NT
rug	RK
rut	RT
sum	SM
sun	SN
fed	FT
led	LT
leg	LK
met	MT
Ned	NT
net	NT
bag	BK
bad	BT
bam	BM
bat	BT
cap	KP
cab	KB
dad	TT
Dan	TN
gas	KS
gag	KK
ham	HM
hat	HT
jab	JB
jam	JM
pan	PN
pat	PT
tab	TB
tag	TK
tan	TN
tap	TP
bid	BT
dig	TK
dip	TP
hid	HT
hit	HT
hip	HP
Jim	JM
jig	JK
kin	KN
kid	KT
pin	PN
pit	PT
pig	PK
tin	TN
tip	TP
Tim	TM
cop	KP
con	KN
Don	TN
dog	TK
hop	HP
hog	HK
job	JB
jog	JK
pot	PT
pop	PP
top	TP
Tom	TM
bug	BK
bud	BT
bum	BM
cup	KP
cub	KB
dud	TT
dug	TK
Gus	KS
gun	KN
hum	HM
jug	JK
pup	PP
tub	TB
tug	TK
beg	BK
bed	BT
bet	BT
hen	HN
jet	JT
Ken	KN
pen	PN
pet	PT
peg	PK
pep	PP
the	0
of	OF
and	ANT
a	A
to	T
in	IN
is	IS
you	Y
that	0T
it	IT
he	H
was	WS
for	FR
on	ON
are	AR
as	AS
with	W0
his	HS
they	0
I	I
at	AT
be	B
this	0S
have	HF
from	FRM
or	OR
one	ON
had	HT
by	B
word	WRT
but	BT
not	NT
what	WT
all	AL
were	WR
we	W
when	WN
your	YR
can	KN
said	ST
there	0R
use	US
an	AN
each	EX
which	WX
she	X
do	T
how	H
their	0R
if	IF
will	WL
up	UP
other	O0R
about	ABT
out	OT
many	MN
then	0N
them	0M
these	0S
so	S
some	SM
her	HR
would	WLT
make	MK
like	LK
him	HM
into	INT
time	TM
has	HS
look	LK
two	TW
more	MR
write	RT
go	K
see	S
number	NMBR
no	N
way	W
could	KLT
people	PPL
my	M
than	0N
first	FRST
water	WTR
been	BN
call	KL
who	W
oil	OL
its	ITS
now	N
find	FNT
long	LNK
down	TN
day	T
did	TT
get	JT
come	KM
made	MT
may	M
part	PRT
over	OFR
new	N
sound	SNT
take	TK
only	ONL
little	LTL
work	WRK
know	N
place	PLS
year	YR
live	LF
me	M
back	BK
give	JF
most	MST
very	FR
after	AFTR
thing	0NK
our	OR
just	JST
name	NM
good	KT
sentence	SNTNS
man	MN
think	0NK
say	S
great	KRT
where	WR
help	HLP
through	0RH
much	MX
before	BFR
line	LN
right	RHT
too	T
mean	MN
old	OLT
any	AN
same	SM
tell	TL
boy	B
follow	FL
came	KM
want	WNT
show	X
also	ALS
around	ARNT
farm	FRM
three	0R
small	SML
set	ST
put	PT
end	ENT
does	TS
another	AN0R
well	WL
large	LRJ
must	MST
big	BK
even	EFN
such	SX
because	BKS
turn	TRN
here	HR
why	W
ask	ASK
went	WNT
men	MN
read	RT
need	NT
land	LNT
different	TFRNT
home	HM
us	US
move	MF
try	TR
kind	KNT
hand	HNT
picture	PKTR
again	AKN
change	XNJ
off	OF
play	PL
spell	SPL
air	AR
away	AW
animal	ANML
house	HS
point	PNT
page	PJ
letter	LTR
mother	M0R
answer	ANSWR
found	FNT
study	STT
still	STL
learn	LRN
should	XLT
America	AMRK
world	WRLT
high	HH
every	EFR
near	NR
add	AT
food	FT
between	BTWN
own	ON
below	BL
country	KNTR
plant	PLNT
last	LST
school	SKL
father	F0R
keep	KP
tree	TR
never	NFR
start	STRT
city	ST
earth	ER0
eye	EY
light	LHT
thought	0HT
head	HT
under	UNTR
story	STR
saw	S
left	LFT
don't	TNT
few	F
while	WL
along	ALNK
might	MHT
chose	XS
something	SM0NK
seem	SM
next	NKST
hard	HRT
open	OPN
example	EKSMPL
begin	BJN
life	LF
always	ALWS
those	0S
both	B0
paper	PPR
together	TJ0R
got	KT
group	KRP
often	OFTN
run	RN
important	IMPRTNT
until	UNTL
children	XLTRN
side	ST
feet	FT
car	KR
mile	ML
night	NHT
walk	WLK
white	WT
sea	S
began	BKN
grow	KR
took	TK
river	RFR
four	FR
carry	KR
state	STT
once	ONS
book	BK
hear	HR
stop	STP
without	W0T
second	SKNT
late	LT
miss	MS
idea	IT
enough	ENH
eat	ET
face	FS
watch	WX
far	FR
Indian	INTN
really	RL
almost	ALMST
let	LT
above	ABF
girl	JRL
sometimes	SMTMS
mountain	MNTN
cut	KT
young	YNK
talk	TLK
soon	SN
list	LST
song	SNK
being	BNK
leave	LF
family	FML
it's	ITS
am	AM
ate	AT
best	BST
better	BTR
black	BLK
blue	BL
bring	BRNK
brown	BRN
buy	B
clean	KLN
cold	KLT
done	TN
draw	TR
drink	TRNK
eight	EHT
fall	FL
fast	FST
five	FF
fly	FL
full	FL
funny	FN
gave	KF
giving	JFNK
goes	KS
green	KRN
hold	HLT
hot	HT
hurt	HRT
jump	JMP
laugh	LH
myself	MSLF
pick	PK
please	PLS
pretty	PRT
pull	PL
ran	RN
red	RT
ride	RT
round	RNT
seven	SFN
shall	XL
sing	SNK
sit	ST
six	SKS
sleep	SLP
ten	TN
thank	0NK
today	TT
upon	UPN
warm	WRM
wash	WX
wish	WX
yellow	YL
yes	YS
act	AKT
ant	ANT
bake	BK
band	BNT
bank	BNK
bell	BL
belt	BLT
Ben	BN
bend	BNT
bent	BNT
Bess	BS
bike	BK
bit	BT
bite	BT
blast	BLST
bled	BLT
blend	BLNT
blimp	BLMP
blink	BLNK
bliss	BLS
block	BLK
blond	BLNT
blot	BLT
bluff	BLF
blunt	BLNT
bone	BN
brag	BRK
brand	BRNT
brass	BRS
brat	BRT
bred	BRT
bride	BRT
brig	BRK
brim	BRM
broke	BRK
brunt	BRNT
brute	BRT
bump	BMP
bun	BN
bunt	BNT
bust	BST
camp	KMP
cane	KN
can't	KNT
cape	KP
cast	KST
cat	KT
clad	KLT
clam	KLM
clamp	KLMP
clan	KLN
clap	KLP
clasp	KLSP
class	KLS
cliff	KLF
cling	KLNK
clink	KLNK
clip	KLP
close	KLS
clot	KLT
club	KLB
clump	KLMP
clung	KLNK
cone	KN
crab	KRB
craft	KRFT
cram	KRM
cramp	KRMP
crib	KRB
crime	KRM
crisp	KRSP
crop	KRP
crust	KRST
cure	KR
cute	KT
dam	TM
damp	TMP
den	TN
dent	TNT
dim	TM
dime	TM
dine	TN
dire	TR
dive	TF
dope	TP
draft	TRFT
drag	TRK
drank	TRNK
dress	TRS
drift	TRFT
drill	TRL
drip	TRP
drop	TRP
drove	TRF
drug	TRK
drum	TRM
dump	TMP
dust	TST
eve	EF
fact	FKT
fade	FT
fell	FL
felt	FLT
file	FL
fill	FL
film	FLM
fine	FN
fire	FR
fist	FST
flag	FLK
flap	FLP
flat	FLT
fled	FLT
fling	FLNK
flip	FLP
flop	FLP
flung	FLNK
flunk	FLNK
frame	FRM
frank	FRNK
frill	FRL
frisk	FRSK
frog	FRK
frost	FRST
froze	FRS
fume	FM
gasp	KSP
gaze	KS
glad	KLT
gland	KLNT
glass	KLS
glint	KLNT
globe	KLB
glum	KLM
golf	KLF
grab	KRB
grade	KRT
gram	KRM
gramp	KRMP
grand	KRNT
grant	KRNT
grape	KRP
grasp	KRSP
grass	KRS
grill	KRL
grim	KRM
grin	KRN
grip	KRP
gripe	KRP
grump	KRMP
grunt	KRNT
gulp	KLP
gust	KST
gut	KT
hate	HT
held	HLT
hide	HT
hint	HNT
hire	HR
hole	HL
honk	HNK
hope	HP
hose	HS
hug	HK
hung	HNK
hunt	HNT
hut	HT
ink	INK
Jan	JN
Jane	JN
joke	JK
junk	JNK
kept	KPT
kit	KT
kite	KT
lamp	LMP
lick	LK
lift	LFT
lime	LM
limp	LMP
lock	LK
luck	LK
lump	LMP
Mack	MK
mask	MSK
mass	MS
mast	MST
mate	MT
melt	MLT
mend	MNT
Mick	MK
Mike	MK
milk	MLK
mill	ML
mint	MNT
mist	MST
mite	MT
mope	MP
mule	ML
mute	MT
neck	NK
nest	NST
nine	NN
nose	NS
note	NT
pane	PN
pant	PNT
pass	PS
past	PST
pest	PST
Pete	PT
pike	PK
pile	PL
pill	PL
pine	PN
plan	PLN
plane	PLN
plank	PLNK
plate	PLT
plop	PLP
plot	PLT
plug	PLK
plum	PLM
plump	PLMP
plus	PLS
poke	PK
pole	PL
pomp	PMP
pond	PNT
pope	PP
prank	PRNK
press	PRS
pride	PRT
prime	PRM
print	PRNT
prize	PRS
prop	PRP
punk	PNK
pure	PR
raft	RFT
ripe	RP
robe	RB
rock	RK
rode	RT
romp	RMP
rope	RP
rose	RS
Runs	RNS
runt	RNT
rust	RST
sack	SK
sake	SK
Sam	SM
sand	SNT
sank	SNK
save	SF
scab	SKB
scale	SKL
scalp	SKLP
scan	SKN
scare	SKR
scat	SKT
scope	SKP
scram	SKRM
scrap	SKRP
script	SKRPT
self	SLF
sell	SL
send	SNT
sent	SNT
sick	SK
site	ST
size	SS
skate	SKT
skid	SKT
skill	SKL
skim	SKM
skin	SKN
skip	SKP
skit	SKT
skunk	SKNK
slam	SLM
slang	SLNK
slant	SLNT
slap	SLP
slat	SLT
slate	SLT
slave	SLF
sled	SLT
slept	SLPT
slide	SLT
slim	SLM
sling	SLNK
slip	SLP
slob	SLB
slope	SLP
slot	SLT
slug	SLK
slum	SLM
slump	SLMP
smack	SMK
smell	SML
smile	SML
smog	SMK
smoke	SMK
smug	SMK
snack	SNK
snag	SNK
snake	SNK
snap	SNP
sniff	SNF
snip	SNP
snipe	SNP
snub	SNB
snug	SNK
sock	SK
soft	SFT
span	SPN
spank	SPNK
spat	SPT
sped	SPT
spend	SPNT
spent	SPNT
spill	SPL
spin	SPN
spine	SPN
spit	SPT
spite	SPT
splat	SPLT
splint	SPLNT
split	SPLT
spoke	SPK
spot	SPT
spun	SPN
spunk	SPNK
stab	STB
stack	STK
stale	STL
stamp	STMP
stand	STNT
stem	STM
step	STP
stiff	STF
sting	STNK
stink	STNK
stomp	STMP
stone	STN
stove	STF
strand	STRNT
strap	STRP
strip	STRP
stripe	STRP
struck	STRK
strung	STRNK
stuck	STK
stump	STMP
stun	STN
suck	SK
sung	SNK
swam	SWM
swang	SWNK
swell	SWL
swift	SWFT
swim	SWM
swing	SWNK
swung	SWNK
tack	TK
tam	TM
tame	TM
tape	TP
tent	TNT
test	TST
tide	TT
tile	TL
till	TL
tilt	TLT
trade	TRT
tramp	TRMP
trap	TRP
trend	TRNT
trick	TRK
trim	TRM
trip	TRP
trot	TRT
trunk	TRNK
trust	TRST
twang	TWNK
twig	TWK
twin	TWN
twist	TWST
van	FN
vane	FN
wave	WF
weld	WLT
wet	WT
win	WN
wind	WNT
wine	WN
wire	WR
yoke	YK
absent	ABSNT
admit	ATMT
album	ALBM
ball	BL
bang	BNK
banging	BNJNK
basket	BSKT
bathtub	B0TB
bedbug	BTBK
bench	BNX
bib	BB
bill	BL
blank	BLNK
blasted	BLSTT
blended	BLNTT
blush	BLX
bobsled	BBSLT
box	BKS
branch	BRNX
brave	BRF
brush	BRX
bunch	BNX
bus	BS
camping	KMPNK
care	KR
case	KS
catnip	KTNP
cave	KF
chest	XST
chill	XL
chin	XN
chip	XP
chipmunk	XPMNK
chop	XP
chunk	XNK
clock	KLK
cloth	KL0
contest	KNTST
crack	KRK
crash	KRX
crashing	KRXNK
crept	KRPT
cross	KRS
crush	KRX
cuff	KF
dash	TX
deck	TK
dentist	TNTST
dish	TX
disrupt	TSRPT
disrupted	TSRPTT
dot	TT
drinking	TRNKNK
dusted	TSTT
expanded	EKSPNTT
fang	FNK
fib	FB
finishing	FNXNK
fish	FX
fix	FKS
flute	FLT
fog	FK
fox	FKS
Fran	FRN
fuss	FS
gift	JFT
goblin	KBLN
gum	KM
hall	HL
hang	HNK
Hank	HNK
himself	HMSLF
hotrod	HTRT
huff	HF
hunted	HNTT
index	INTKS
insisted	INSSTT
insisting	INSSTNK
insulted	INSLTT
invent	INFNT
invented	INFNTT
Jack	JK
jumping	JMPNK
king	KNK
kiss	KS
lane	LN
lapdog	LPTK
lasted	LSTT
lending	LNTNK
loft	LFT
lost	LST
lug	LK
lunch	LNX
lung	LNK
mall	ML
mascot	MSKT
math	M0
mess	MS
mob	MB
mug	MK
napkin	NPKN
pack	PK
Pam	PM
path	P0
picnic	PKNK
pigpen	PKPN
pinball	PNBL
pinch	PNX
planted	PLNTT
plastic	PLSTK
problem	PRBLM
public	PBLK
publishing	PBLXNK
puff	PF
punishing	PNXNK
quake	KK
rake	RK
rash	RX
rented	RNTT
rest	RST
rested	RSTT
rich	RX
ring	RNK
ringing	RNJNK
rub	RB
safe	SF
sale	SL
sang	SNK
sash	SX
shack	XK
shed	XT
shelf	XLF
shell	XL
shifted	XFTT
shine	XN
ship	XP
shop	XP
shrimp	XRMP
shrinking	XRNKNK
shrunk	XRNK
shut	XT
sink	SNK
sinking	SNKNK
sits	STS
splash	SPLX
splashing	SPLXNK
squinted	SKNTT
standing	STNTNK
Steve	STF
stub	STB
stuff	STF
stunt	STNT
sub	SB
sunfish	SNFX
sunk	SNK
sunlit	SNLT
sunset	SNST
suntan	SNTN
swishing	SWXNK
talented	TLNTT
tall	TL
tank	TNK
throne	0RN
thud	0T
tick	TK
tilted	TLTT
tiptop	TPTP
toss	TS
trusted	TRSTT
twisted	TWSTT
upset	UPST
vent	FNT
vest	FST
wag	WK
wall	WL
wax	WKS
whiff	WF
whip	WP
whiplash	WPLX
wig	WK
wing	WNK
wink	WNK
wipe	WP
wise	WS
yell	YL
zap	SP
zigzag	SKSK
called	KLT
circle	SRKL
friend	FRNT
Mr	MR
	
Mrs	MRS
	
nothing	N0NK
says	SS
Ann	AN
Beth	B0
Bing	BNK
Blanch	BLNX
bong	BNK
Buck	BK
burnt	BRNT
Burt	BRT
Carmen	KRMN
Cass	KS
caterpillar	KTRPLR
Chad	XT
cheer	XR
chomp	XMP
Chuck	XK
chuckle	XKL
chug	XK
Clark	KLRK
click	KLK
climb	KLM
clown	KLN
cluck	KLK
coal	KL
complain	KMPLN
croak	KRK
crunch	KRNX
Curtis	KRTS
curve	KRF
darts	TRTS
dinner	TNR
diver	TFR
doctor	TKTR
doll	TL
door	TR
Doris	TRS
Ellen	ELN
fellow	FL
fiddle	FTL
firm	FRM
fishing	FXNK
Fitch	FX
foam	FM
forever	FRFR
forgot	FRKT
forth	FR0
front	FRNT
Gert	JRT
gobble	KBL
gone	KN
gosh	KX
granddad	KRNTT
grandpa	KRNTP
grinned	KRNT
grumble	KRMBL
hatch	HX
Herb	HRB
hill	HL
horse	HRS
hush	HX
insect	INSKT
Jeff	JF
jiggle	JKL
Jill	JL
Jill's	JLS
Josh	JX
jumble	JMBL
kick	KK
Kim	KM
Kirk	KRK
larch	LRX
library	LBRR
lived	LFT
lives	LFS
market	MRKT
Mitch	MX
mix	MKS
napper	NPR
nibble	NBL
Nick	NK
Norm	NRM
Oh	O
onto	ONT
owner	ONR
patch	PX
peck	PK
perfect	PRFKT
ping	PNK
Pip	PP
pong	PNK
quick	KK
quill	KL
quilt	KLT
Quinn	KN
quit	KT
reward	RWRT
Rex	RKS
Rick	RK
Rivera	RFR
roam	RM
ruff	RF
Sanchez	SNXS
served	SRFT
Seth	S0
sister	SSTR
Sloan	SLN
smash	SMX
snort	SNRT
snuggle	SNKL
soup	SP
sparkle	SPRKL
sprinkle	SPRNKL
squirt	SKRT
stick	STK
sudden	STN
sunburn	SNBRN
surprise	SRPRS
swimmer	SWMR
Tad	TT
tadpole	TTPL
Ted	TT
Tess	TS
Texas	TKSS
tickle	TKL
toad	TT
Todd	TT
turf	TRF
twinkle	TWNKL
twitch	TWX
umbrella	UMBRL
uncle	UNKL
wham	WM
whirl	WRL
whisper	WSPR
whistle	WSTL
wiggle	WKL
window	WNT
Winkle	WNKL
writing	RTNK
yet	YT
York	YRK
zing	SNK
zip	SP
able	ABL
ace	AS
added	ATT
afraid	AFRT
afternoon	AFTRNN
age	AJ
ahead	AHT
annoy	AN
anything	AN0NK
anyway	ANW
anywhere	ANHR
ape	AP
applaud	APLT
arm	ARM
artist	ARTST
attack	ATK
attic	ATK
auto	AT
avoid	AFT
awesome	AWSM
awful	AFL
awning	ANNK
babble	BBL
baby	BB
baffle	BFL
bald	BLT
ballplayer	BLPLYR
bark	BRK
base	BS
baseball	BSBL
basin	BSN
basketball	BSKTBL
batch	BX
bath	B0
battle	BTL
beach	BX
bead	BT
beam	BM
bean	BN
beanstalk	BNSTLK
beast	BST
beat	BT
bedtime	BTTM
bee	B
beef	BF
beehive	BHF
beet	BT
begging	BKNK
behind	BHNT
bird	BRT
birthday	BR0T
bleach	BLX
blew	BL
blind	BLNT
bloom	BLM
blow	BL
blown	BLN
bluebird	BLBRT
blueprint	BLPRNT
blur	BLR
boast	BST
boat	BT
bob	BB
body	BT
boil	BL
bold	BLT
bonnet	BNT
bonus	BNS
boost	BST
boot	BT
born	BRN
bottle	BTL
bowl	BL
brace	BRS
braid	BRT
brain	BRN
brainstorm	BRNSTRM
brake	BRK
brawl	BRL
bread	BRT
breakfast	BRKFST
breath	BR0
brick	BRK
bright	BRHT
broil	BRL
broiler	BRLR
broom	BRM
bruise	BRS
bubble	BBL
buddy	BT
built	BLT
bundle	BNTL
bunk	BNK
bunny	BN
burn	BRN
burst	BRST
buses	BSS
butterfly	BTRFL
button	BTN
buzz	BS
cabin	KBN
cage	KJ
cake	KK
camel	KML
candle	KNTL
candy	KNT
careful	KRFL
cart	KRT
catch	KX
cattle	KTL
cell	SL
cent	SNT
chain	XN
chalk	XLK
champ	XMP
charge	XRJ
chart	XRT
chase	XS
chat	XT
check	XK
cheerful	XRFL
cheese	XS
chess	XS
chew	X
chick	XK
child	XLT
chime	XM
chirp	XRP
choice	XS
chore	XR
church	XRX
churn	XRN
claim	KLM
classmate	KLSMT
clay	KL
clerk	KLRK
clever	KLFR
clue	KL
clutch	KLX
coach	KX
coat	KT
coax	KKS
coil	KL
coin	KN
collect	KLKT
colorful	KLRFL
cool	KL
core	KR
cork	KRK
corn	KRN
cowboy	KB
cozy	KS
crate	KRT
crawl	KRL
cream	KRM
crew	KR
crinkle	KRNKL
crow	KR
cruise	KRS
cry	KR
cuddle	KTL
cupcake	KPKK
curb	KRB
curl	KRL
dab	TB
daddy	TT
dangle	TNKL
Danny	TN
dark	TRK
dart	TRT
date	TT
dawn	TN
daylight	TLHT
dead	TT
deaf	TF
dealt	TLT
decent	TSNT
deep	TP
delight	TLHT
desk	TSK
die	T
dimple	TMPL
dirt	TRT
ditch	TX
doghouse	TKHS
double	TBL
dragon	TRKN
dragonfly	TRKNFL
drain	TRN
dread	TRT
dream	TRM
drew	TR
driveway	TRFW
droop	TRP
dry	TR
duck	TK
due	T
dunk	TNK
dusk	TSK
easel	ESL
easy	ES
egg	EK
elbow	ELB
enjoy	ENJ
ever	EFR
evergreen	EFRKRN
everyone	EFRYN
everything	EFR0NK
everywhere	EFRHR
explore	EKSPLR
fabric	FBRK
fail	FL
faithful	F0FL
fame	FM
fault	FLT
fawn	FN
feast	FST
feed	FT
feel	FL
fence	FNS
fern	FRN
fetch	FX
fifty	FFT
fight	FHT
finish	FNX
firefighter	FRFHTR
flagpole	FLKPL
flash	FLX
flashlight	FLXLHT
flaunt	FLNT
flaw	FL
flight	FLHT
float	FLT
flow	FL
fluffy	FLF
foal	FL
foil	FL
fold	FLT
fool	FL
forest	FRST
forget	FRJT
fork	FRK
form	FRM
fort	FRT
fraud	FRT
fray	FR
free	FR
fresh	FRX
Friday	FRT
fried	FRT
fright	FRHT
frozen	FRSN
fruit	FRT
fry	FR
fur	FR
game	KM
garden	KRTN
gate	KT
gel	JL
gem	JM
germ	JRM
giggle	JKL
ginger	JNJR
giraffe	JRF
gleam	KLM
glean	KLN
glow	KL
gluestick	KLSTK
goat	KT
going	KNK
gold	KLT
goose	KS
Grace	KRS
graceful	KRSFL
grain	KRN
grapefruit	KRPFRT
grasshopper	KRSHPR
grateful	KRTFL
gray	KR
grew	KR
groan	KRN
grown	KRN
grown-up	KRNP
growth	KR0
gumball	KMBL
habit	HBT
hail	HL
handwriting	HNTRTNK
happen	HPN
happy	HP
harm	HRM
harmful	HRMFL
harp	HRP
haul	HL
haunt	HNT
hawk	HK
hay	H
health	HL0
heat	HT
heavy	HF
heel	HL
hello	HL
helpful	HLPFL
herself	HRSLF
hi	H
hidden	HTN
highway	HHW
hoist	HST
homemade	HMMT
homework	HMWRK
hoot	HT
hopeful	HPFL
hopscotch	HPSKX
horn	HRN
host	HST
houseboat	HSBT
housefly	HSFL
huddle	HTL
human	HMN
humid	HMT
hummingbird	HMNKBRT
hump	HMP
hungry	HNKR
hunk	HNK
hurdle	HRTL
hurl	HRL
ice	IS
inch	INX
inside	INST
instead	INSTT
itch	IX
Jake	JK
jar	JR
jaw	J
Jean	JN
jeep	JP
jelly	JL
jellyfish	JLFX
Jen	JN
jerk	JRK
Jimmy	JM
jingle	JNKL
Jo	J
Joan	JN
join	JN
joint	JNT
joy	J
juggle	JKL
juice	JS
jungle	JNKL
kickball	KKBL
kingfish	KNKFX
kits	KTS
kitten	KTN
kitty	KT
knack	NK
knee	N
kneecap	NKP
kneel	NL
knelt	NLT
knew	N
knife	NF
knight	NHT
knit	NT
knob	NB
knock	NK
knockout	NKT
knot	NT
knothole	N0L
known	NN
lace	LS
lack	LK
lake	LK
latch	LX
launch	LNX
law	L
lawn	LN
lay	L
lazy	LS
leap	LP
leather	L0R
Lee	L
lemon	LMN
less	LS
lie	L
lighthouse	LH0S
limit	LMT
link	LNK
lipstick	LPSTK
living	LFNK
load	LT
loaf	LF
loop	LP
loose	LS
lot	LT
low	L
lunchbox	LNXBKS
Mabel	MBL
mail	ML
main	MN
mane	MN
march	MRX
mark	MRK
match	MX
Matt	MT
meant	MNT
meat	MT
meet	MT
mice	MS
middle	MTL
mild	MLT
mind	MNT
mine	MN
mitten	MTN
moan	MN
model	MTL
moist	MST
mold	MLT
moment	MMNT
Monday	MNT
moo	M
mood	MT
motel	MTL
mow	M
munch	MNX
music	MSK
muzzle	MSL
nab	NB
nail	NL
nanny	NN
Nate	NT
neat	NT
necktie	NKT
nerve	NRF
newscast	NSKST
newspaper	NSPPR
nice	NS
nickname	NKNM
nighttime	NHTM
nips	NPS
noise	NS
noon	NN
north	NR0
nowhere	NHR
oak	OK
oat	OT
oatmeal	OTML
object	OBJKT
oink	ONK
ooze	OS
outside	OTST
ox	OKS
pace	PS
paddle	PTL
pail	PL
pain	PN
painful	PNFL
paint	PNT
pal	PL
pancake	PNKK
paperback	PPRBK
park	PRK
pause	PS
paw	P
pawn	PN
pay	P
peace	PS
peaceful	PSFL
peach	PX
peak	PK
peddle	PTL
peep	PP
pencil	PNSL
pennies	PNS
penny	PN
perch	PRX
piano	PN
pie	P
pillow	PL
pilot	PLT
pink	PNK
pipe	PP
pitch	PX
ploy	PL
poison	PSN
pony	PN
pooch	PX
poodle	PTL
pool	PL
popcorn	PPKRN
porch	PRX
port	PRT
post	PST
poster	PSTR
potpie	PTP
pretzel	PRTSL
price	PRS
proof	PRF
pupil	PPL
puppy	PP
purple	PRPL
purse	PRS
puzzle	PSL
quack	KK
queen	KN
quicksand	KKSNT
rabbit	RBT
race	RS
rack	RK
rage	RJ
rail	RL
rain	RN
rainbow	RNB
ranch	RNX
rang	RNK
rattle	RTL
raw	R
ray	R
reach	RX
ready	RT
recycle	RSKL
refund	RFNT
renew	RN
restful	RSTFL
return	RTRN
ribbon	RBN
rice	RS
riddle	RTL
rind	RNT
rink	RNK
rise	RS
road	RT
roast	RST
rob	RB
robin	RBN
robot	RBT
room	RM
roost	RST
row	R
Roy	R
royal	RYL
ruled	RLT
rumble	RMBL
runway	RNW
rush	RX
saddle	STL
sag	SK
sail	SL
sailboat	SLBT
salad	SLT
sample	SMPL
sandbox	SNTBKS
sandpaper	SNTPPR
sandy	SNT
Saturday	STRT
sauce	SS
saucer	SSR
scarf	SKRF
scold	SKLT
scorch	SKRX
score	SKR
scrape	SKRP
scratch	SKRX
scream	SKRM
screen	SKRN
screw	SKR
scrub	SKRB
seal	SL
seat	ST
serve	SRF
settle	STL
shade	XT
shadow	XT
shake	XK
shaking	XKNK
shameful	XMFL
shape	XP
share	XR
shark	XRK
sharp	XRP
sheep	XP
shipwreck	XPRK
shirt	XRT
shore	XR
short	XRT
shrink	XRNK
shrub	XRB
shrug	XRK
shy	X
sidewalk	STWLK
sigh	SH
sight	SHT
silence	SLNS
silly	SL
simple	SMPL
sips	SPS
sir	SR
siren	SRN
sky	SK
slice	SLS
slick	SLK
slight	SLHT
slow	SL
slur	SLR
sly	SL
smart	SMRT
smiling	SMLNK
smooth	SM0
snail	SNL
sneak	SNK
snooze	SNS
snore	SNR
snow	SN
snowball	SNBL
snowflake	SNFLK
snowman	SNMN
soak	SK
soap	SP
sofa	SF
soil	SL
someone	SMN
somewhere	SMHR
sore	SR
sort	SRT
soy	S
space	SPS
spark	SPRK
speak	SPK
splendid	SPLNTT
splotch	SPLX
spoil	SPL
spool	SPL
spoon	SPN
sport	SPRT
sprain	SPRN
sprawl	SPRL
spray	SPR
spread	SPRT
spring	SPRNK
sprint	SPRNT
spruce	SPRS
spur	SPR
squawk	SKK
stage	STJ
star	STR
startle	STRTL
stay	ST
steam	STM
steep	STP
stern	STRN
stiffer	STFR
stir	STR
stool	STL
store	STR
stork	STRK
storm	STRM
strain	STRN
strange	STRNJ
straw	STR
stray	STR
stream	STRM
street	STRT
stretch	STRX
strict	STRKT
strike	STRK
string	STRNK
strong	STRNK
stung	STNK
sue	S
suit	ST
suitcase	STKS
sunblock	SNBLK
Sunday	SNT
sunflower	SNFLWR
sunny	SN
sunrise	SNRS
sunshine	SNXN
surf	SRF
sway	SW
sweat	SWT
sweep	SWP
sweet	SWT
swerve	SWRF
swimming	SWMNK
swirl	SWRL
switch	SWX
tablet	TBLT
tail	TL
taps	TPS
tattle	TTL
taught	THT
tea	T
teach	TX
teacher	TXR
team	TM
tease	TS
teeth	T0
tennis	TNS
thankful	0NKFL
thick	0K
thigh	0H
thimble	0MBL
thin	0N
thinner	0NR
thinnest	0NST
third	0RT
thirst	0RST
thorn	0RN
thread	0RT
threat	0RT
thrill	0RL
throat	0RT
throw	0R
Thursday	0RST
tie	T
tiger	TJR
tight	THT
tired	TRT
toast	TST
toil	TL
told	TLT
tool	TL
tooth	T0
topcoat	TPKT
torch	TRX
torn	TRN
tot	TT
tow	T
toy	T
trace	TRS
traffic	TRFK
train	TRN
trash	TRX
travel	TRFL
tray	TR
tread	TRT
treetop	TRTP
trouble	TRBL
truck	TRK
trumpet	TRMPT
Tuesday	TST
tugboat	TKBT
tulip	TLP
tumble	TMBL
tummy	TM
turtle	TRTL
tusk	TSK
twirl	TWRL
ugly	UKL
unzip	UNSP
useful	USFL
value	FL
vanish	FNX
verb	FRB
verse	FRS
vine	FN
visit	FST
visitor	FSTR
voice	FS
void	FT
vote	FT
waddle	WTL
wage	WJ
wagon	WKN
wait	WT
wake	WK
waves	WFS
wealth	WL0
weather	W0R
weave	WF
web	WB
Wednesday	WTNST
weed	WT
week	WK
weekend	WKNT
wettest	WTST
whack	WK
whale	WL
whatever	WTFR
wheat	WT
wheel	WL
whenever	WNFR
whisk	WSK
whiz	WS
wide	WT
wife	WF
wild	WLT
windmill	WNTML
wonderful	WNTRFL
wore	WR
worn	WRN
wrap	RP
wreath	R0
wreck	RK
wrench	RNX
wriggle	RKL
wrinkle	RNKL
wrist	RST
wristwatch	RSTWX
written	RTN
wrong	RNK
wrote	RT
yak	YK
yard	YRT
yardstick	YRTSTK
yarn	YRN
yawn	YN
yum	YM
Zack	SK
zebra	SBR
zoo	S
zoom	SM
ban	BN
bar	BR
winter	WNTR
bay	B
wear	WR
bye	BY
mitten	MTN
aid	AT
aim	AM
arc	ARK
art	ART
ash	AX
axe	AKS
cog	KK
cot	KT
cow	K
dew	T
ear	ER
eel	EL
elf	ELF
elk	ELK
elm	ELM
era	ER
fee	F
fig	FK
fir	FR
flu	FL
gap	KP
guy	K
icy	IS
inn	IN
ivy	IF
Jay	J
key	K
nag	NK
oar	OR
odd	OT
owe	OW
owl	OL
pea	P
pod	PT
rib	RB
sew	S
ski	SK
sob	SB
son	SN
sow	S
spa	SP
spy	SP
tar	TR
tax	TKS
toe	T
vet	FT
war	WR
won	WN
yap	YP
zen	SN
ax	AKS
bait	BT
barn	BRN
bawl	BL
beak	BK
birth	BR0
blab	BLB
blade	BLT
blame	BLM
blaze	BLS
bleed	BLT
bless	BLS
blip	BLP
blurb	BLRB
blurt	BLRT
bog	BK
bond	BNT
boo	B
books	BKS
booth	B0
bow	B
boys	BS
brad	BRT
bran	BRN
brawn	BRN
brisk	BRSK
brook	BRK
broth	BR0
brother	BR0R
card	KRT
cash	KX
cask	KSK
caw	K
cheap	XP
cheek	XK
chow	X
clack	KLK
clang	KLNK
clash	KLX
claw	KL
cloak	KLK
clod	KLT
coast	KST
cob	KB
cod	KT
code	KT
cook	KK
coop	KP
cord	KRT
cost	KST
count	KNT
coy	K
crane	KRN
crick	KRK
crock	KRK
crook	KRK
crown	KRN
crude	KRT
crumb	KRM
cube	KB
cue	K
dear	TR
disk	TSK
dock	TK
doze	TS
drake	TRK
drape	TRP
drawn	TRN
drive	TRF
dude	TT
east	EST
Ed	ET
faint	FNT
flake	FLK
flame	FLM
flesh	FLX
flick	FLK
flirt	FLRT
flit	FLT
flock	FLK
floor	FLR
flour	FLR
flown	FLN
flush	FLX
fond	FNT
foot	FT
fowl	FL
Fred	FRT
fret	FRT
frizz	FRS
frying	FRYNK
fuse	FS
gang	KNK
glade	KLT
glaze	KLS
glee	KL
glen	KLN
glide	KLT
glob	KLB
gloss	KLS
goal	KL
gown	KN
grate	KRT
greet	KRT
grit	KRT
grouch	KRX
growl	KRL
gruff	KRF
heal	HL
heap	HP
hem	HM
hike	HK
hood	HT
hoof	HF
hook	HK
hoop	HP
howl	HL
huge	HJ
husk	HSK
imp	IMP
intern	INTRN
jail	JL
jib	JB
June	JN
jut	JT
laid	LT
lame	LM
leak	LK
lend	LNT
lent	LNT
lien	LN
lint	LNT
loan	LN
loin	LN
lone	LN
loot	LT
lop	LP
lord	LRT
loud	LT
lurk	LRK
lute	LT
maid	MT
maze	MS
meal	ML
mirth	MR0
mock	MK
mole	ML
moon	MN
mouse	MS
mouth	M0
murk	MRK
musk	MSK
nook	NK
nurse	NRS
pad	PT
paid	PT
peek	PK
peel	PL
pelt	PLT
perk	PRK
plain	PLN
plants	PLNTS
player	PLYR
plod	PLT
plow	PL
plums	PLMS
pork	PRK
prance	PRNS
pray	PR
prayer	PRYR
present	PRSNT
prim	PRM
prince	PRNS
probe	PRB
prod	PRT
program	PRKRM
proud	PRT
prowl	PRL
pry	PR
punt	PNT
raid	RT
rant	RNT
real	RL
rent	RNT
risk	RSK
Rome	RM
roof	RF
rude	RT
rung	RNK
scald	SKLT
scar	SKR
scoop	SKP
scoot	SKT
scout	SKT
scowl	SKL
scuff	SKF
scum	SKM
seek	SK
seen	SN
shawl	XL
sheet	XT
shirk	XRK
shook	XK
shoot	XT
shot	XT
shout	XT
shown	XN
sift	SFT
silk	SLK
sixth	SKS0
skips	SKPS
skirt	SKRT
skull	SKL
slash	SLX
slaw	SL
slay	SL
slid	SLT
slit	SLT
slop	SLP
smear	SMR
smith	SM0
smock	SMK
smoky	SMK
snare	SNR
snatch	SNX
sneeze	SNS
snob	SNB
snoop	SNP
snuff	SNF
soot	ST
sour	SR
south	S0
speck	SPK
speech	SPX
speed	SPT
spike	SPK
spry	SPR
spud	SPT
spurn	SPRN
spurt	SPRT
stain	STN
stall	STL
Stan	STN
steal	STL
stood	STT
sulk	SLK
swamp	SWMP
swan	SWN
swap	SWP
swarm	SWRM
swat	SWT
swatch	SWX
swept	SWPT
swig	SWK
swine	SWN
swish	SWX
swoop	SWP
sworn	SWRN
swum	SWM
tale	TL
task	TSK
tend	TNT
tenth	TN0
term	TRM
thumb	0M
tint	TNT
tock	TK
town	TN
toys	TS
track	TRK
trail	TRL
tram	TRM
trek	TRK
tribe	TRB
trod	TRT
Troy	TR
tune	TN
tweed	TWT
tweet	TWT
twelve	TWLF
twenty	TWNT
twice	TWS
twine	TWN
twitter	TWTR
urge	URJ
urn	URN
uses	USS
vase	FS
vow	F
wade	WT
wed	WT
wept	WPT
west	WST
whine	WN
whir	WR
wick	WK
wilt	WLT
woke	WK
wood	WT
woof	WF
wool	WL
wove	WF
wow	W
zest	SST
zone	SN
against	AKNST
American	AMRKN
among	AMNK
asked	ASKT
course	KRS
days	TS
didn't	TTNT
during	TRNK
eyes	EYS
general	JNRL
given	JFN
however	HWFR
later	LTR
order	ORTR
possible	PSBL
president	PRSTNT
rather	R0R
since	SNS
states	STTS
system	SSTM
things	0NKS
though	0H
toward	TWRT
united	UNTT
used	UST
years	YRS
color	KLR
suddenly	STNL
zipper	SPR
ah	A
ho	H
Ma	M
Pa	P
TV	TF
ago	AK
baa	B
God	KT
hoe	H
I'd	IT
I'm	IM
sis	SS
ill	IL
O	O
K	K
ache	AX
aunt	ANT
bare	BR
bear	BR
boom	BM
busy	BS
dare	TR
lose	LS
love	LF
none	NN
rule	RL
sure	SR
tire	TR
tube	TB
copy	KP
edge	EJ
else	ELS
fizz	FS
glue	KL
hair	HR
half	HLF
hour	HR
I'll	IL
I've	IF
July	JL
kill	KL
lady	LT
lamb	LM
leaf	LF
liar	LR
lion	LN
mama	MM
mash	MX
meow	M
mush	MX
obey	OB
okay	OK
ouch	OX
oven	OFN
papa	PP
pour	PR
push	PX
roll	RL
shoe	X
soda	ST
tiny	TN
worm	WRM
TRUE	TR
U	U
S	S
	
agree	AKR
alive	ALF
apple	APL
April	APRL
awake	AWK
blood	BLT
break	BRK
chair	XR
cloud	KLT
cough	KH
cover	KFR
dance	TNS
erase	ERS
phone	FN
piece	PS
whole	WL
whose	WS
adult	ATLT
angry	ANKR
belly	BL
death	T0
eagle	EKL
empty	EMPT
extra	EKSTR
hurry	HR
maybe	MB
money	MN
movie	MF
nasty	NST
party	PRT
pizza	PS
quiet	KT
sorry	SR
stair	STR
sugar	SKR
table	TBL
taste	TST
threw	0R
touch	TX
towel	TWL
truth	TR0
waist	WST
waste	WST
woman	WMN
women	WMN
won't	WNT
worse	WRS
anyone	ANYN
arrive	ARF
asleep	ASLP
August	AKST
avenue	AFN
behave	BHF
bridge	BRJ
carpet	KRPT
cereal	SRL
choose	XS
cookie	KK
corner	KRNR
crayon	KRYN
danger	TNJR
minute	MNT
banana	BNN
bucket	BKT
carrot	KRT
dollar	TLR
finger	FNJR
flower	FLWR
gentle	JNTL
handle	HNTL
listen	LSTN
mirror	MRR
monkey	MNK
nickel	NKL
nobody	NBT
orange	ORNJ
parent	PRNT
person	PRSN
pocket	PKT
potato	PTT
puppet	PPT
rocket	RKT
search	SRX
secret	SKRT
seesaw	SS
shovel	XFL
shower	XWR
silent	SLNT
spider	SPTR
sponge	SPNJ
squash	SKX
squeak	SKK
sticky	STK
summer	SMR
supper	SPR
they'd	0T
ticket	TKT
tiptoe	TPT
tissue	TS
tomato	TMT
tongue	TNK
turkey	TRK
unfair	UNFR
wonder	WNTR
U	U
S	S
A	A
	
airport	ARPRT
anybody	ANBT
balloon	BLN
bedroom	BTRM
bicycle	BSKL
brownie	BRN
cartoon	KRTN
ceiling	SLNK
channel	XNL
chicken	XKN
garbage	KRBJ
promise	PRMS
squeeze	SKS
address	ATRS
blanket	BLNKT
earache	ERX
excited	EKSSTT
good-bye	KTBY
grandma	KRNTM
grocery	KRSR
indoors	INTRS
January	JNR
kitchen	KXN
lullaby	LLB
monster	MNSTR
morning	MRNNK
naughty	NHT
October	OKTBR
pajamas	PJMS
pretend	PRTNT
quarter	KRTR
shampoo	XMP
stomach	STMX
there's	0RS
they'll	0L
they're	0R
they've	0F
tonight	TNHT
unhappy	UNHP
airplane	ARPLN
alphabet	ALFBT
bathroom	B0RM
favorite	FFRT
medicine	MTSN
December	TSMBR
dinosaur	TNSR
elephant	ELFNT
February	FBRR
football	FTBL
forehead	FRHT
headache	HTX
hospital	HSPTL
lollipop	LLPP
November	NFMBR
outdoors	OTTRS
question	KSXN
railroad	RLRT
remember	RMMBR
sandwich	SNTWX
scissors	SSSRS
shoulder	XLTR
softball	SFTBL
tomorrow	TMR
upstairs	UPSTRS
vacation	FKXN
restroom	RSTRM
astronaut	ASTRNT
beautiful	BTFL
bumblebee	BMBLB
cardboard	KRTBRT
chocolate	XKLT
Christmas	XRSTMS
classroom	KLSRM
cranberry	KRNBR
drugstore	TRKSTR
furniture	FRNTR
milkshake	MLKXK
nightmare	NHTMR
telephone	TLFN
difficult	TFKLT
everybody	EFRBT
hamburger	HMBRJR
September	SPTMBR
spaceship	SPSXP
spaghetti	SPKHT
stoplight	STPLHT
underwear	UNTRWR
yesterday	YSTRT
ice	IS
cream	KRM
automobile	ATMBL
blackboard	BLKBRT
downstairs	TNSTRS
photograph	FTKRF
strawberry	STRBR
television	TLFXN
toothbrush	T0BRX
toothpaste	T0PST
baby-sitter	BBSTR
post	PST
office	OFS
grandfather	KRNTF0R
grandmother	KRNTM0R
potato	PTT
chip	XP
upside	UPST
down	TN
kindergarten	KNTRKRTN
refrigerator	RFRJRTR
Thanksgiving	0NKSJFNK
hide-and-seek	HTNTSK
United	UNTT
States	STTS
pumpkin	PMPKN
salt	SLT
melted	MLTT
handed	HNTT
printed	PRNTT
landed	LNTT
wanted	WNTT
filled	FLT
showed	XWT
hugged	HKT
tugged	TKT
planned	PLNT
jogged	JKT
spilled	SPLT
smelled	SMLT
grilled	KRLT
slammed	SLMT
rushed	RXT
spelled	SPLT
saved	SFT
baked	BKT
named	NMT
lined	LNT
smiled	SMLT
closed	KLST
helped	HLPT
jumped	JMPT
looked	LKT
clapped	KLPT
tapped	TPT
kicked	KKT
dropped	TRPT
zipped	SPT
wished	WXT
pitched	PXT
missed	MST
walked	WLKT
worked	WRKT
she'll	XL
you'll	YL
he'll	HL
we're	WR
she's	XS
he's	HS
you're	YR
we're	WR
jazz	JS
